..........//o//oo//.
..//o//......   ....
....S..  ..       ..
  ..////.//o//......
/.///o///.///././///
..........//o//oo//.
..//o//......   ....
.......  ..       ..
  ..////.//o//......
/.///o///.///././///
..........//o//oo//.
..//o//......   ....
.......  ..       ..
  ..////.//o//......
/.///o///.///././///