..........
..//o//...
....S.....
//..////..
..........