..........
..//o//...
....S..  .
//..////..
..........