..........//o//o   .
    o//........    .
....S.. ...       ..
  ..////.//o//......
/.///o///.///././///
..........//o//oo//.
..//o//......   ....
.......  ..       ..
  ..////.//o//......
/.///o///.///././///
..........//o//oo//.
..//o//......   ....
.......  ..       ..
  ..////.//o//......
/.///o///.///././///